11 12 70 70 70 40 41 42 40 41 42 40 41 42 40 41 42 40 41 42 40 41 42 40 41 42 40 41 42 40 41 42 40 41 42 40 41 42 40 41 42 40 41 42 40 41 42 40 41 42 40 41 42 40 41 42 40 41 42 20
21 22 70 70 70 70 70 70 70 70 70 70 70 70 70 70 70 70 70 70 70 70 70 70 70 70 70 70 70 70 70 70 70 70 70 70 70 70 70 70 70 70 70 70 70 70 70 70 70 70 70 70 70 70 70 70 70 70 70 30
11 12 70 70 70 70 70 70 70 70 70 70 70 70 70 70 70 70 70 70 70 70 70 70 70 70 70 70 70 70 70 70 70 70 70 70 70 70 70 70 70 70 70 70 70 70 70 70 70 70 70 70 70 70 70 70 70 70 70 20
21 22 70 70 70 70 70 70 70 70 70 70 70 70 60 70 70 70 70 70 70 70 70 70 70 70 70 70 70 70 70 70 70 70 70 70 70 70 70 70 70 70 70 70 70 70 70 70 70 70 70 70 70 70 70 70 70 70 70 30
11 12 70 70 70 70 70 61 62 70 70 70 70 70 70 70 70 70 70 70 70 70 70 70 70 60 70 70 70 70 70 73 74 70 70 70 70 70 70 70 70 70 70 70 70 70 70 70 70 70 70 70 61 62 70 70 70 70 70 20
21 22 70 70 70 70 70 71 72 70 70 70 70 70 70 70 70 70 70 70 70 70 70 70 70 70 70 70 70 70 70 83 84 70 70 70 60 70 70 70 70 70 70 70 70 70 70 70 60 70 70 70 71 72 70 70 60 70 70 30
11 12 70 70 70 70 70 81 82 70 70 70 70 70 70 70 70 70 70 70 70 70 70 70 70 70 70 70 70 70 70 70 70 70 70 70 70 70 70 70 70 70 70 70 70 70 70 70 70 70 70 70 81 82 70 70 70 70 70 20
21 22 70 70 70 70 70 70 70 70 70 70 70 70 70 70 70 70 61 62 70 70 70 70 70 70 70 70 70 70 70 70 70 70 70 70 70 70 70 70 70 70 70 70 70 70 70 70 70 70 70 70 70 70 70 70 70 70 70 30
11 12 70 70 70 70 70 70 70 70 70 70 70 60 70 70 70 70 71 72 70 70 70 70 70 60 70 70 70 70 70 70 70 70 70 70 70 70 70 70 61 62 70 70 70 70 70 70 70 70 70 70 70 70 70 70 70 70 70 20
21 22 70 70 70 70 70 70 73 74 70 70 70 70 70 70 70 70 81 82 70 70 70 70 70 70 70 70 70 70 70 70 70 70 70 70 70 70 70 70 71 72 70 70 70 70 70 70 70 70 70 70 70 70 70 70 70 70 70 30
11 12 70 70 70 70 70 70 83 84 70 70 70 70 70 70 70 70 70 70 70 70 70 70 70 70 70 70 70 70 70 70 70 70 70 70 70 70 70 70 81 82 70 70 60 70 70 70 70 70 70 70 70 70 70 70 70 70 70 20
21 22 70 70 70 70 70 70 70 70 70 70 70 70 70 70 70 70 70 70 70 70 70 70 70 70 70 70 70 70 70 70 70 70 70 70 70 70 70 70 70 70 70 70 70 70 70 70 70 70 70 70 70 70 70 70 70 70 70 30
11 12 70 70 70 70 70 70 70 70 70 70 70 70 70 70 70 70 70 70 70 70 70 70 70 70 70 70 70 70 70 70 70 60 70 70 70 70 70 70 70 70 70 70 70 70 70 70 70 70 70 70 70 70 70 70 70 70 70 20
21 22 70 70 70 70 70 70 70 70 70 70 70 70 70 70 60 70 70 70 70 70 70 60 70 70 70 70 70 70 70 70 70 70 70 70 70 70 70 70 70 70 70 70 70 70 70 70 70 70 70 70 70 70 70 70 70 70 70 30
11 12 70 70 70 70 70 70 70 70 70 70 70 70 70 70 70 70 70 70 70 70 70 70 70 70 70 70 70 70 70 70 70 70 70 70 70 70 70 70 70 70 70 70 70 70 70 73 74 70 70 70 70 60 70 70 70 70 70 20
21 22 70 70 70 70 70 70 70 70 70 70 70 70 70 70 70 70 70 70 70 70 70 70 70 70 70 70 73 74 70 70 70 70 70 70 70 70 70 70 70 70 70 70 70 70 70 83 84 70 70 70 70 70 70 70 70 70 70 30
11 12 70 70 70 60 70 70 70 70 70 70 70 70 70 70 70 70 70 70 70 70 70 70 70 70 70 70 83 84 70 70 70 70 70 70 70 70 70 70 60 70 70 70 70 70 70 70 70 70 70 70 70 70 70 70 70 70 70 20
21 22 70 70 70 70 70 70 70 70 70 70 70 70 70 60 70 70 70 70 70 70 70 70 70 70 70 70 70 70 70 70 70 70 70 70 70 70 70 70 70 70 70 70 70 70 70 70 70 70 70 70 70 70 70 70 70 70 70 30
11 12 70 70 70 70 70 70 70 70 70 70 70 70 70 70 70 70 70 61 62 70 70 70 70 70 70 70 70 70 70 70 70 70 70 70 70 70 70 70 70 70 70 70 70 70 70 70 70 61 62 70 70 70 70 70 70 70 70 20
21 22 70 70 70 70 70 70 70 70 70 70 70 70 70 70 70 70 70 71 72 70 70 70 70 60 70 70 70 70 70 70 70 60 70 70 61 62 70 70 70 70 70 70 70 70 70 70 70 71 72 70 70 70 70 60 70 70 70 30
11 12 70 70 70 70 70 70 70 70 70 70 70 70 70 70 70 70 70 81 82 70 70 70 70 70 70 70 70 70 70 70 70 70 70 70 71 72 70 70 70 70 70 70 60 70 70 70 70 81 82 70 70 70 70 70 70 70 70 20
21 22 70 70 73 74 70 70 70 70 70 70 70 70 73 74 70 70 70 70 70 70 70 70 70 70 70 70 70 70 70 70 70 70 70 70 81 82 70 70 70 70 70 70 70 70 70 70 70 70 70 70 70 70 70 70 70 70 70 30
11 12 70 70 83 84 70 70 70 70 70 70 70 70 83 84 70 70 70 70 70 70 70 70 70 70 70 70 70 70 70 70 70 70 70 70 70 70 70 70 70 70 70 70 70 70 70 70 70 70 70 70 70 70 70 70 70 70 70 20
21 22 70 70 70 70 70 70 70 70 70 70 70 70 70 70 70 70 70 70 70 70 70 70 70 70 70 70 70 70 70 70 70 70 70 70 70 70 70 70 70 70 70 70 70 70 70 70 70 70 60 70 70 70 70 70 70 70 70 30
11 12 70 70 70 70 70 70 70 70 70 70 70 70 70 70 70 70 70 70 70 70 70 70 70 70 70 70 70 70 70 70 70 70 70 70 70 70 60 70 70 70 70 70 70 70 70 70 70 70 70 70 70 70 70 70 70 70 70 20
21 22 70 70 70 70 70 60 70 70 70 70 70 70 70 70 60 70 70 70 70 70 70 70 70 70 70 70 70 70 70 60 70 70 70 70 70 70 70 70 70 70 70 70 70 70 70 70 70 70 70 70 70 70 70 70 70 70 70 30
11 12 70 70 70 70 70 70 70 70 70 70 70 70 70 70 70 70 70 70 70 70 70 70 70 60 70 70 70 70 70 70 70 70 70 70 70 70 70 70 70 70 70 70 70 70 70 70 70 70 70 70 70 70 70 70 70 70 70 20
21 22 70 70 70 70 70 70 70 70 70 70 70 70 70 70 70 70 70 70 70 70 70 70 70 70 70 70 70 70 70 70 70 70 70 70 70 70 70 70 70 70 70 70 70 60 70 70 70 70 70 70 70 70 70 60 70 70 70 30
11 12 70 70 70 70 70 70 70 70 70 70 70 70 70 70 70 70 70 70 70 70 70 70 70 70 70 70 70 70 70 70 70 70 70 70 70 70 70 70 70 70 70 70 70 70 70 70 70 70 70 70 70 70 70 70 70 70 70 20
21 22 70 70 70 70 70 70 70 70 70 70 70 70 60 70 70 70 70 70 70 61 62 70 70 70 70 73 74 70 70 70 70 70 70 70 60 70 70 70 70 70 70 70 70 70 70 70 70 70 73 74 70 70 70 70 70 70 70 30
11 12 70 70 70 70 70 70 70 70 70 70 70 70 70 70 70 70 70 70 70 71 72 70 70 70 70 83 84 70 70 70 70 70 70 70 70 70 70 70 70 70 70 70 70 70 70 70 70 70 83 84 70 70 70 70 70 70 70 20
21 22 70 70 70 70 60 70 70 70 70 70 70 70 70 70 70 70 70 70 70 81 82 70 70 70 70 70 70 70 70 70 70 70 70 70 70 70 70 70 70 70 70 70 70 70 70 70 70 70 70 70 70 70 70 70 70 70 70 30
11 12 70 70 70 70 70 70 70 70 70 70 70 70 70 70 70 70 70 70 70 70 70 70 70 70 70 70 70 70 70 70 70 70 70 70 70 70 70 70 70 70 60 70 70 70 70 70 70 70 70 70 70 70 70 70 70 70 70 20
21 22 70 70 70 70 70 70 70 70 70 70 70 70 70 70 70 70 70 70 70 70 70 70 70 70 70 70 70 70 70 70 70 60 70 70 70 70 70 70 70 70 70 70 70 70 70 70 70 70 70 70 70 70 70 70 70 70 70 30
11 12 70 70 70 70 70 70 61 62 70 70 70 70 70 70 60 70 70 70 70 70 70 70 60 70 70 70 70 70 70 70 70 70 70 70 70 70 70 70 70 70 70 70 70 70 70 70 70 70 70 70 70 60 70 70 70 70 70 20
21 22 70 70 70 70 70 70 71 72 70 70 70 70 70 70 70 70 70 70 70 70 70 70 70 70 70 70 70 70 70 70 70 70 70 70 70 70 70 70 70 70 70 70 70 70 70 70 70 70 70 70 70 70 70 70 70 70 70 30
11 12 70 70 70 70 70 70 81 82 70 70 70 70 70 70 70 70 70 70 70 70 70 70 70 70 70 70 70 70 70 70 70 70 70 70 70 70 60 70 70 73 74 70 70 70 70 70 70 70 70 70 70 70 70 70 61 62 70 20
21 22 70 70 70 60 70 70 70 70 70 70 70 60 70 70 70 70 70 70 70 70 70 70 70 70 70 70 70 70 70 70 70 70 70 70 70 70 70 70 70 83 84 70 70 70 70 70 60 70 70 70 70 70 70 70 71 72 70 30
11 12 70 70 70 70 70 70 70 70 70 70 70 70 70 70 70 70 70 70 70 70 70 70 70 70 70 70 70 70 70 70 70 70 70 70 70 70 70 70 70 70 70 70 70 70 70 70 70 70 70 70 70 70 70 70 81 82 70 20
21 22 0 1 2 0 1 2 0 1 2 0 1 2 0 1 2 0 1 2 0 1 2 0 1 2 0 1 2 0 1 2 0 1 2 0 1 2 0 1 2 0 1 2 0 1 2 0 1 2 0 1 2 0 1 2 0 1 2 30