11 15 16 16 16 16 16 16 16 16 16 16 16 16 16 16 16 16 16 16 16 16 16 16 16 16 16 16 16 16 16 16 16 16 16 16 16 16 16 16 16 16 16 16 16 16 16 16 16 16 16 16 16 16 16 16 16 16 13 11
21 25 26 26 26 26 27 28 29 26 26 26 26 26 26 26 26 26 26 27 9 29 26 26 26 26 26 26 26 26 26 26 26 26 26 26 26 26 27 8 29 26 26 26 26 26 26 26 26 26 26 27 9 29 26 26 26 26 23 21
11 12 70 70 70 70 37 38 39 70 70 70 70 70 70 70 70 70 70 37 17 39 70 70 70 70 70 70 70 70 70 70 70 70 70 70 70 70 37 18 39 70 70 70 70 70 70 70 70 70 70 37 19 39 70 70 70 70 10 11
21 22 70 70 70 70 47 48 49 70 70 70 70 70 70 70 70 70 70 47 48 49 70 70 70 70 70 70 70 70 70 70 70 70 70 61 62 70 47 48 49 70 70 70 70 70 70 70 70 70 70 47 48 49 70 70 70 70 20 21
11 12 70 70 70 70 80 80 80 70 70 70 70 61 62 70 70 70 70 80 80 80 70 61 62 70 70 70 70 70 70 70 70 70 70 71 72 70 80 80 80 70 70 70 70 70 70 61 62 70 70 80 80 80 70 70 70 70 10 11
21 22 70 70 70 70 80 80 80 70 70 70 70 71 72 70 70 70 70 80 80 80 70 71 72 70 70 70 70 70 70 61 62 70 70 81 82 70 80 80 80 70 70 73 74 70 70 71 72 70 70 80 80 80 70 70 70 70 20 21
11 12 70 70 70 70 80 80 80 70 70 70 70 81 82 70 70 70 70 80 80 80 70 81 82 70 70 70 70 70 70 71 72 70 70 70 70 70 80 80 80 70 70 83 84 70 70 81 82 70 70 80 80 80 70 70 70 70 10 11
21 22 70 60 70 70 80 80 80 70 70 70 70 70 70 70 70 70 70 80 80 80 70 70 70 70 70 70 70 70 70 81 82 70 70 70 70 70 80 80 80 70 70 70 70 70 70 70 70 70 70 80 80 80 70 70 70 70 20 21
11 12 70 70 70 70 80 80 80 70 70 70 70 70 70 70 70 70 70 80 80 80 70 70 70 70 70 70 70 70 70 70 70 70 70 70 70 70 80 80 80 70 70 70 70 70 70 70 70 70 70 80 80 80 70 70 70 70 10 11
21 22 70 70 70 70 80 80 80 80 80 80 80 80 80 80 80 80 80 80 80 80 80 80 80 80 80 80 80 80 80 80 80 80 80 80 80 80 80 80 80 80 80 80 80 80 80 80 80 80 80 80 80 80 70 70 70 70 20 21
11 12 70 70 70 70 80 80 80 80 80 80 80 80 80 80 80 80 80 80 80 80 80 80 80 80 80 80 80 80 80 80 80 80 80 80 80 80 80 80 80 80 80 80 80 80 80 80 80 80 80 80 80 80 70 70 70 70 10 11
21 22 70 70 70 70 70 70 70 70 70 70 70 70 70 70 70 70 70 70 70 70 70 70 70 70 70 70 70 80 80 80 70 70 70 70 70 70 70 70 70 70 70 70 70 70 70 70 70 70 70 70 70 70 70 70 70 70 20 21
11 12 70 70 60 70 70 70 70 70 70 70 70 70 70 70 70 70 60 70 70 70 70 70 70 61 62 70 70 80 80 80 70 70 60 70 70 70 70 60 70 70 70 70 70 61 62 70 70 70 70 70 70 70 70 70 70 70 10 11
21 22 70 70 70 70 70 61 62 70 70 70 73 74 70 70 70 70 70 70 70 70 70 70 70 71 72 70 70 80 80 80 70 70 70 70 70 70 70 70 70 70 70 70 70 71 72 70 70 60 70 70 70 70 70 70 70 70 20 21
11 12 70 70 70 70 70 71 72 70 70 70 83 84 70 70 70 70 61 62 70 70 70 70 70 81 82 70 70 80 80 80 70 70 70 70 70 61 62 70 70 70 70 70 70 81 82 70 70 70 70 70 61 62 70 70 70 70 10 11
21 22 70 70 70 70 70 81 82 70 70 70 70 70 70 70 70 70 71 72 70 70 70 70 70 70 70 70 70 80 80 80 70 70 70 70 70 71 72 70 70 73 74 70 70 70 70 70 70 70 70 70 71 72 70 70 70 70 20 21
11 12 70 70 70 70 70 70 70 70 70 70 70 70 70 70 70 70 81 82 70 70 73 74 70 70 70 70 90 91 92 93 94 70 70 70 70 81 82 70 70 83 84 70 70 70 70 70 70 70 70 70 81 82 70 70 70 70 10 11
21 22 70 70 70 70 70 70 70 70 70 70 70 70 70 70 70 70 70 70 70 70 83 84 70 70 70 80 100 101 102 103 104 80 70 70 70 70 70 70 70 70 70 70 70 70 70 70 70 70 70 70 70 70 70 70 70 70 20 21
11 12 70 70 70 70 70 70 70 70 61 62 70 70 70 70 70 70 70 70 70 70 70 70 70 70 70 80 110 111 112 113 114 80 70 70 70 70 70 70 70 70 70 70 70 70 70 61 62 70 70 70 70 70 70 70 70 70 10 11
21 22 70 70 70 70 70 70 70 70 71 72 70 70 70 70 70 70 70 70 70 70 70 70 70 70 70 80 120 121 122 123 124 80 70 70 70 70 70 70 61 62 70 70 70 70 70 71 72 70 70 60 70 70 70 70 70 70 20 21
11 12 70 70 70 70 70 70 70 70 81 82 70 70 60 70 70 70 70 70 70 70 70 70 70 70 70 80 130 131 132 133 134 80 70 70 70 70 70 70 71 72 70 70 70 70 70 81 82 70 70 70 70 70 61 62 70 70 10 11
21 22 70 70 70 70 70 70 70 70 70 70 70 70 70 70 70 70 70 70 70 61 62 70 70 70 70 80 80 80 80 80 80 80 70 70 73 74 70 70 81 82 70 70 70 70 70 70 70 70 70 70 70 70 71 72 70 70 20 21
11 12 70 70 70 73 74 70 70 70 70 70 70 70 70 70 70 70 70 70 70 71 72 70 70 70 70 70 70 80 80 80 70 70 70 70 83 84 70 70 70 70 70 70 70 70 70 70 70 70 70 70 70 70 81 82 70 70 10 11
21 22 70 70 70 83 84 70 70 70 70 70 70 70 70 70 70 70 70 70 70 81 82 70 70 70 70 70 70 80 80 80 70 70 70 70 70 70 70 70 70 70 70 70 70 70 70 70 70 70 70 70 70 70 70 70 70 70 20 21
11 12 70 70 70 70 70 70 70 70 70 70 70 60 70 70 70 70 70 70 70 70 70 70 70 70 70 70 70 80 80 80 70 70 70 70 70 70 70 70 70 70 61 62 70 70 70 70 70 70 70 70 61 62 70 70 70 70 10 11
21 22 70 70 70 70 70 70 70 70 70 70 70 70 70 70 70 70 73 74 70 70 70 70 70 70 70 70 70 80 80 80 70 70 70 70 70 70 70 70 70 70 71 72 70 70 70 70 60 70 70 70 71 72 70 70 70 70 20 21
11 12 70 70 70 70 70 61 62 70 70 70 70 70 70 70 70 70 83 84 70 70 70 70 70 60 70 70 70 80 80 80 70 70 70 70 61 62 70 70 70 70 81 82 70 70 70 70 70 70 70 70 81 82 70 70 70 70 10 11
21 22 70 70 70 70 70 71 72 70 70 70 70 70 70 70 70 70 70 70 70 70 70 70 70 70 70 70 70 80 80 80 70 70 70 70 71 72 70 70 70 70 70 70 70 70 70 70 70 70 70 70 70 70 70 70 70 70 20 21
11 12 70 70 70 70 70 81 82 70 70 70 70 70 70 70 70 70 70 70 70 70 70 70 70 70 70 70 70 80 80 80 70 70 70 70 81 82 70 70 70 70 70 70 70 70 70 70 70 70 70 70 70 70 70 70 70 70 10 11
21 22 70 70 70 60 70 70 70 70 70 70 70 70 70 61 62 70 70 70 70 70 70 70 70 70 70 61 62 80 80 80 70 70 70 70 70 70 70 70 73 74 70 70 70 70 70 61 62 70 70 70 70 70 70 70 70 70 20 21
11 12 70 70 70 70 70 70 70 70 70 70 70 70 70 71 72 70 70 70 70 70 70 70 70 70 70 71 72 80 80 80 70 70 70 70 70 70 70 70 83 84 70 70 70 70 70 71 72 70 70 70 70 70 60 70 70 70 10 11
21 22 70 70 70 70 70 70 70 70 70 70 70 70 70 81 82 70 70 70 70 70 70 70 70 70 70 81 82 80 80 80 70 70 70 70 70 70 70 70 70 70 70 70 70 70 70 81 82 70 70 70 70 70 70 70 70 70 20 21
11 12 70 70 70 70 70 70 70 70 70 70 70 70 70 70 70 70 70 70 70 70 70 70 70 70 70 70 70 80 80 80 70 70 70 70 70 70 70 70 70 70 70 70 70 70 70 70 70 70 70 70 70 70 70 70 70 70 10 11
21 22 80 80 80 80 80 80 80 80 80 80 80 80 80 80 80 80 80 80 80 80 80 80 80 80 80 80 80 80 80 80 70 61 62 70 70 70 70 70 70 61 62 70 70 70 70 70 70 70 70 70 70 70 61 62 70 70 20 21
11 12 80 80 80 80 80 80 80 80 80 80 80 80 80 80 80 80 80 80 80 80 80 80 80 80 80 80 80 80 80 80 70 71 72 70 70 70 70 70 70 71 72 70 70 70 70 73 74 70 70 70 70 70 71 72 70 70 10 11
21 22 80 80 70 70 70 70 70 70 70 70 70 70 70 70 70 70 70 70 70 70 70 70 70 70 70 70 70 70 70 70 70 81 82 70 70 70 70 70 70 81 82 70 70 70 70 83 84 70 70 70 70 70 81 82 70 70 20 21
11 12 80 80 70 70 70 70 60 70 70 70 70 70 70 70 70 70 70 70 70 70 70 70 70 70 70 70 60 70 70 70 70 70 70 70 70 70 70 70 70 70 70 70 70 70 70 70 70 70 70 70 70 70 70 70 70 70 10 11
21 22 80 80 70 70 70 70 70 70 70 70 70 70 60 70 70 70 70 70 70 70 70 70 70 70 70 70 70 70 70 70 70 70 70 70 70 70 70 70 70 70 70 70 70 70 70 70 70 70 70 70 70 70 70 70 70 70 20 21
11 12 80 80 0 1 2 0 1 2 0 1 2 0 1 2 0 1 2 0 1 2 0 1 2 0 1 2 0 1 2 0 1 2 0 1 2 0 1 2 0 1 2 0 1 2 0 1 2 0 1 2 0 1 2 0 1 2 10 11
21 22 80 80 10 11 12 10 11 12 10 11 12 10 11 12 10 11 12 10 11 12 10 11 12 10 11 12 10 11 12 10 11 12 10 11 12 10 11 12 10 11 12 10 11 12 10 11 12 10 11 12 10 11 12 10 11 12 20 21