12 12 12 12 12 12 12 12 12 12 12 12 12 12 12 12 12 12 12 12 12 12 12 12 12 12 12 12 12 12 12 12 12 12 12 12 12 12 12 12
11 11 11 11 11 11 11 11 11 11 11 11 11 11 11 11 11 11 11 11 11 11 11 11 11 11 11 11 11 11 11 11 11 11 11 11 11 11 11 11
12 12 12 12 12 12 12 12 12 12 12 12 12 12 12 12 12 12 12 12 12 12 12 12 12 12 12 12 12 12 12 12 12 12 12 12 12 12 12 12
11 11 0 0 0 0 0 0 0 0 0 0 0 0 0 2 0 0 0 0 0 0 0 0 0 0 0 0 0 0 0 0 0 0 0 0 0 0 11 11
12 12 0 0 0 0 0 0 0 0 0 0 0 0 2 0 0 0 0 0 0 0 0 0 0 0 0 0 0 0 0 0 2 0 0 0 0 0 12 12
11 11 0 0 0 0 0 0 0 0 0 0 21 21 21 21 21 21 21 21 21 21 21 21 21 21 21 21 0 0 2 0 0 0 0 0 0 0 11 11
12 12 0 2 2 0 0 0 0 0 0 0 21 21 21 21 21 21 21 21 21 21 21 21 21 21 21 21 0 0 0 0 0 0 0 0 0 0 12 12
11 11 0 0 0 2 0 0 0 0 0 0 21 21 21 21 21 21 21 21 21 21 21 21 21 21 21 21 0 0 0 0 0 0 0 0 2 0 11 11
12 12 0 0 0 0 0 0 2 2 0 0 21 21 21 21 21 21 21 21 21 21 21 21 21 21 21 21 0 0 0 2 2 0 0 0 0 0 12 12
11 11 0 0 0 0 0 0 0 2 2 0 21 21 21 21 21 21 21 21 21 21 21 21 21 21 21 21 0 0 0 0 0 0 0 0 0 0 11 11
12 12 0 0 0 0 0 0 0 0 0 0 20 20 20 20 20 20 20 20 20 20 20 20 20 20 20 20 0 0 0 0 0 0 0 0 0 0 12 12
11 11 0 0 0 0 0 0 0 2 0 0 20 20 20 20 20 20 20 20 20 20 20 20 20 20 20 20 0 2 0 0 0 0 0 0 0 0 11 11
12 12 0 0 0 2 0 0 0 0 0 0 20 20 20 20 20 20 20 22 22 20 20 20 20 20 20 20 0 0 0 0 0 0 0 0 0 0 12 12
11 11 0 0 0 0 0 0 0 0 0 0 0 0 0 0 0 0 0 1 1 0 0 2 0 0 0 0 0 0 0 0 0 0 0 0 0 0 11 11
12 12 0 0 0 0 0 0 0 0 0 0 0 0 0 0 0 1 1 0 0 0 0 0 0 0 0 0 0 0 0 0 0 0 0 2 2 0 12 12
11 11 0 0 0 0 2 0 0 0 13 0 0 13 0 1 1 0 0 13 0 0 0 0 0 0 0 13 0 0 0 0 0 0 0 0 0 0 11 11
12 12 2 0 0 0 0 0 0 0 0 0 0 1 1 0 13 0 0 13 13 13 0 2 13 0 13 13 0 0 0 0 0 0 13 0 2 0 12 12
11 11 0 0 0 13 13 0 0 13 0 13 1 1 0 0 0 0 0 0 2 0 0 0 0 13 13 0 0 0 0 13 0 13 0 0 0 0 11 11
12 12 0 2 0 13 13 0 0 0 0 0 1 1 13 13 0 0 0 13 0 0 0 0 0 0 0 0 13 0 13 13 0 13 13 0 0 0 12 12
11 11 0 0 0 13 0 0 0 0 2 0 1 1 0 13 0 13 0 0 0 0 13 13 0 0 0 0 0 0 0 0 0 2 13 0 2 2 11 11
12 12 0 0 0 0 0 0 0 13 0 13 1 1 13 2 13 13 0 0 0 0 0 0 0 2 0 0 0 0 13 13 13 0 2 2 0 2 12 12
11 11 0 0 2 0 13 0 0 0 13 0 0 1 1 0 0 0 13 0 0 0 0 0 0 13 0 0 13 0 0 0 0 0 2 0 0 0 11 11
12 12 0 0 2 2 0 13 0 13 0 0 0 0 1 1 13 0 0 0 0 13 13 0 0 0 0 13 13 0 0 0 0 0 0 0 0 0 12 12
11 11 0 0 0 0 0 0 13 13 0 13 0 0 0 1 1 0 0 0 0 0 13 0 13 2 0 0 2 0 13 0 0 0 0 0 0 0 11 11
12 12 0 0 0 0 0 0 13 0 13 13 0 0 0 0 0 1 1 0 0 13 0 13 0 2 13 0 0 0 0 13 0 0 0 0 0 0 12 12
11 11 0 0 0 13 0 0 0 0 0 13 0 0 13 0 13 0 0 1 1 2 13 2 0 0 0 2 0 0 13 0 0 13 0 0 0 0 11 11
12 12 0 0 0 0 13 0 0 0 0 0 0 0 0 0 0 13 0 0 0 1 1 0 0 0 0 0 0 0 0 0 13 0 0 0 0 0 12 12
11 11 0 0 0 2 0 13 0 0 0 0 0 0 0 0 13 0 13 13 0 0 0 1 1 13 0 0 0 0 13 13 13 0 0 0 0 0 11 11
12 12 0 0 0 0 13 13 2 0 0 13 0 13 0 0 0 0 13 0 13 0 0 13 0 1 1 13 13 0 0 0 0 0 0 0 0 0 12 12
11 11 0 0 0 0 0 0 0 13 0 13 0 0 0 0 0 13 0 13 0 2 0 0 13 0 1 1 0 0 0 13 2 0 0 0 0 0 11 11
12 12 0 0 0 0 0 0 0 0 0 0 0 2 0 0 0 0 0 0 0 13 0 0 0 0 0 1 1 0 0 0 0 0 0 0 0 0 12 12
11 11 0 2 0 0 13 0 0 0 0 0 13 0 0 0 0 0 0 0 0 0 0 0 0 0 0 1 1 0 0 13 0 0 0 0 0 0 11 11
12 12 0 0 0 0 0 0 13 0 0 13 0 0 2 13 0 13 13 0 0 0 0 0 0 13 0 1 1 0 0 0 0 0 0 0 0 0 12 12
11 11 0 0 0 0 13 13 0 13 0 0 13 13 0 0 0 13 0 0 0 0 13 0 13 13 0 1 1 13 0 0 0 0 13 0 0 0 11 11
12 12 0 0 0 0 0 0 0 0 0 0 0 0 0 0 0 0 0 0 0 0 0 0 0 0 1 1 0 0 0 0 0 0 0 0 0 0 12 12
11 11 0 0 0 0 0 0 0 0 2 0 0 0 0 0 0 0 0 0 0 0 2 0 1 1 0 0 0 0 0 0 2 0 0 0 0 0 11 11
12 12 0 0 0 0 0 0 0 0 0 0 0 0 0 0 0 0 0 0 0 0 0 1 1 0 0 0 0 0 0 0 0 0 0 0 0 0 12 12
11 11 0 0 0 0 0 0 0 0 0 0 0 0 0 0 0 0 0 0 0 1 1 2 0 0 0 0 0 0 0 0 0 0 0 0 0 0 11 11
12 12 12 12 12 12 12 12 12 12 12 12 12 12 12 12 12 12 12 1 1 12 12 12 12 12 12 12 12 12 12 12 12 12 12 12 12 12 12 12
11 11 11 11 11 11 11 11 11 11 11 11 11 11 11 11 11 11 11 11 11 11 11 11 11 11 11 11 11 11 11 11 11 11 11 11 11 11 11 11